25,13
wwwwwwwwwwwwwwwwwwwwwwwww
w.....w.....s.....w....5w
w.....w.....w.....w.....w
w.....w.....w.....w.....w
w.....s.....w.....w.....w
w.....w.....w.....s.....w
wswwwww.....wwwwwsw.....w
w.....wwwwsww.....wwswwww
w.....w.....s.....w.....w
w.....w.....w.....w.....w
w.....w.....w.....w.....w
wA....s.....w.....s.....w
wwwwwwwwwwwwwwwwwwwwwwwww
