25,13
wwwwwwwwwwwwwwwwwwwwwwwww
w.....w...........w....5w
w.....w.....w.....w.....w
w..s..w..s..w.....w..s..w
w...........w..s..w.....w
w.....w.....w...........w
w.wwwww.....wwwww.w.....w
w.....wwww.ww.....ww.wwww
w.....w........s..w.....w
w..s..w.....w.....w.....w
w.....w...s.w.....w...s.w
wA..........w...........w
wwwwwwwwwwwwwwwwwwwwwwwww
