25,13
wwwwwwwwwwwwwwwwwwwwwwwww
w.....w...........w....5w
w.....w.....w.....w.....w
w.....w.....w.....w.....w
w...........w.....w.....w
w.....w.....w...........w
w.wwwww.....wwwww.w.....w
w.....wwww.ww.....ww.wwww
w.....w...........w.....w
w.....w....ww.....w.....w
w.....w.....w.....w.....w
wA..........w...........w
wwwwwwwwwwwwwwwwwwwwwwwww
