Five Boxes 7
7,10
wwwwwww
w.o*..w
wo....w
wo..www
wow.www
wow.*Aw
w..**.w
ww*w..w
.w....w
.wwwwww
