Default
8,7
wwwwwwww
ww.....w
ww.*..ww
ww.....w
w......w
w..Aw.ow
wwwwwwww
