Three Boxes 10
7,9
wwwww..
wo..www
wow...w
wo....w
w.w.www
w.*.*Aw
ww..*.w
.www..w
...wwww
